..####..
..#XX#..
.##X.#..
.#XO.@#.
##..O.##
#.OO#..#
#......#
########
