....###....
....#X#....
....#.#....
....#.#....
#####O#####
#X..O@O..X#
#####O#####
....#.#....
....#.#....
....#X#....
....###....
