########
#.....##
#X@.O..#
#......#
#......#
#..O.X.#
#......#
##.....#
########
